                                                                                                                                                     
                                                                                                                                                     
   +-------------------------+           +------------------------+        +------------------------+            +----+              +-----+         
   |.........................#############........................|        |........................##############....+--------------+.....|         
   |......+------------------+           |....+-------------------+        |....+-------------------+            |.........................|         
   |......|                              |....|                            |....|                                |.........................|         
   |......|                              |....|                            |....|                                |.........................++        
   |......|                              |....|                            |....|                               ++..........................++       
   |......|                              |....|                            |....|                              ++............................+       
   |......|                              |....|                            |....|                              |.............................|       
   |......|                              |....|                            |....|                              |.............................|       
   |......|                              |....|                            |....+--------------------+         |.............................|       
   +--#---+                              |....+--------------------+       |.........................|         ++............................|       
      #                                  |.........................|       |.........................|          +...........................++       
      #                                  +--------------------+....|       +--------------------+....|          ++.........................++        
   +--#---+                                                   |....|                            |....|           ++.......................++         
   |......|                                                   |....|                            |....|      +---+ ++....................+-+          
   |......|                                                   |....|                            |....########...++ ++++++...........+---+            
   |......|                                                   |....|                            |....|      +-+..+-+   ++...........+                
   |......|                                                   |....|                            |....|        ++...+---+............|                
   |......|                                                   |....|                            |....|         ++...................|                
   |......|                                                   |....|                            |....|          +--+................|                
   |......|                                                   |....|                            |....|             +---+............|                
   |......+------------------+           +--------------------+....|       +--------------------+....|                 |............|                
   |.........................#############.........................#########.........................|                 |............|                
   +-------------------------+           +-------------------------+       +-------------------------+                 +------------+                
                                                                                                                                                     
                                                                                                                                                     